HHHHHHHHHHHHHHHHHHHHHHHHHHHHHHH
|. . . . . . . C . . . . . . .|
| | ___________________ . | . |
|. . . . . . . . . . . . . . .|
| ___________ . | ___ . _____ |
|. . . . . . . . . . . . . . .|
| | | _______ . _ . | . | . | |
|C . . . . . . . . . . . . . C|
| _____ . | _____________ | . |
|. . . . . .              |. .|
| . | | . _______ | _____ | __|
|. . . . .                 . .|
| ___ . |   _____________ . | |
|. . . .|.                   .|
|HHHHHHHHHHHHHHHHHHHHHHHHHHHHH|
